17 8
#################
#               #
#               #
#   #           #
#               #
#               #
#               #
#################
