17 8
#################
#               #
#               #
#   #   #       #
#   +   #       #
#   #+###       #
#               #
#################
