17 8
#################
#        #      #
#        #  ##  #
#####    #  ##  #
#   #        #  #
#        #   #  #
#   #    #      #
#################
