10 8
##########
#        #
#        #
#####    #
#   #    #
#        #
#   #    #
##########
