17 8
#################
#               #
#        #  ##  #
#####    #  ##  #
#   #        #  #
#        #   #  #
#   #    #      #
#################
